111111111111111111111111
101C10000E000000000E0001
110000C00010000000000001
100000P00000000000000C01
110000000000000000000001
1E1C1000000000C0000E0001
111111111111111111111111