111111111111111111
1P1000111111111111
101010111111111111
1C101000000C000E11
101011111101111111
10100001110111E111
101111C11101110111
100000011100000111
111111111111111111