1111111111111111111111111111111
1000000000000X01E00000000C11101
1000000X00000001111111110111001
10X0000000000P00000000000000001
1111111111111111111111111111111