11111111111111111
1X0010000000000P1
100010000000000C1
100X10000000000E1
11111111111111111